"**************",
"*P           *",
"*            *",
"*            *",
"*        S   *",
"*            *",
"*         B  *",
"*     G      *",
"*         B  *",
"*           E*",
"**************"