"**************",
"*P           *",
"*            *",
"*            *",
"*        E   *",
"*            *",
"*         E  *",
"*     E      *",
"*         E  *",
"*           G*",
"**************"