"**************",
"*P           *",
"*            *",
"*            *",
"*            *",
"*      G     *",
"*         B  *",
"*     G      *",
"*          S *",
"*      S    E*",
"**************"